R 1000 1000
NO     ./textures/eagle.xpm                          
SO ./textures/colorstone.xpm         
WE ./textures/greystone.xpm  
EA ./textures/mossy.xpm  

S ./textures/barrel.xpm  
F 153,119,119
C 50,50,255

        1111111111111111111111111
        1000000000110000000000001
        1011000001110000002000001
        1001000000000000000000001
111111111011000001112000000000001
100000000011000001110111110111111
11110111111111011100000010001
11110111111111011101010010001
11000000110101011100000010001
10000200000000001100000010001
10000000000000001101010010001
11000001110101011111011110N01
11110111 1110101 101111010001
11111111 1111111 111111111111