R 1000 900
NO      ./textures/eagle.xpm                          
SO ./textures/colorstone.xpm         
WE./textures/greystone.xpm  
EA ./textures/mossy.xpm  

S ./textures/barrel.xpm  
F 153,119,119
C 50,50,255

        1111111111111111111111111
        1000000000110000002000001
        1011000001110020002000101
        100100000000000000000010111
11111111101100000111000200000010001
10000000001100000111011111011111101
11110111111111011100000010001   111
11110111111111011101010010001
11000000110101011100000010001111
1000020000000000110000001000001
10000000000000001101010010001111
11000001110101011111011110N01
11110111 1110101 101111010001
11111111 1111111 111111111111



str=./textures/eagle.xpm
