R 640 640
NO     ./textures/eagle.xpm                          
SO ./textures/colorstone.xpm         
WE ./textures/greystone.xpm  
EA ./textures/mossy.xpm  

S ./textures/barrel.xpm  
F 153,119,119
C 50,50,255

111111111
100000001
100020001
100000001
1000N0001
100000001
100000001
100000001
111111111