R 640	640   
NO     ./path_to_the_north_texture                          
SO ./path_to_the_south_texture          
WE ./path_to_the_west_texture
EA ./path_to_the_east_texture

S ./path_to_the_sprite_texture
F 220,100,0
C 225,30,0

1111        1111
1001        1001
10011111111110011
10000000000000001
1001111111111N011
1001        10001
1111        1111